-1  -1  -1  -1  -1  -1  -1  -1
-1  -1  -1  -1  -1  -1  -1  -1
-1  -1  -1  5  5  -1  -1  -1
-1  -1  5  -1  -1  0  -1  -1
-1  0  -1  31  31  -1  0  -1
0  -1  31  31  31  31  -1  5
0  -1  31  31  31  31  -1  5
-1  0  -1  31  31  -1  0  -1
-1  -1  0  -1  -1  0  -1  -1
-1  -1  -1  5  5  -1  -1  -1
-1  -1  -1  -1  -1  -1  -1  -1
1  -1  1  -1  1  -1  1  -1
-1  -1  -1  -1  -1  -1  -1  -1
-1  0  -1  5  -1  0  -1  0
-1  -1  -1  -1  -1  -1  -1  -1
