-1  -1  -1  -1  -1  -1  -1  -1
-1  -1  -1  -1  -1  -1  -1  -1
0  0  0  0  0  0  0  0
1  1  1  1  1  1  1  1
-1  -1  -1  -1  -1  -1  -1  -1
-1  31  -1  -1  -1  -1  31  -1
-1  -1  -1  -1  -1  -1  -1  -1
1  0  1  0  1  0  1  0
-1  -1  -1  -1  -1  -1  -1  -1
-1  -1  -1  32  -1  -1  -1  -1
-1  -1  -1  -1  -1  -1  -1  -1
-1  -1  -1  -1  -1  -1  -1  -1
-1  -1  -1  -1  -1  -1  -1  -1
-1  -1  -1  -1  -1  -1  -1  -1
-1  -1  -1  -1  -1  -1  -1  -1
