-1  -1  -1  -1  -1  -1  -1  -1
1  1  5  1  5  1  1  1
0  0  0  0  5  5  0  0
-1  -1  -1  -1  -1  -1  -1  -1
-1  31  -1  -1  -1  -1  31  -1
-1  -1  -1  -1  -1  -1  -1  -1
1  1  5  1  1  5  1  1
-1  -1  -1  32  -1  -1  -1  -1
1  1  1  1  1  1  1  1
-1  -1  -1  -1  -1  -1  -1  -1
-1  31  -1  1  5  -1  31  -1
-1  -1  -1  1  1  -1  -1  -1
-1  32  -1  5  0  -1  32  -1
-1  -1  -1  -1  -1  -1  -1  -1
-1  -1  -1  -1  -1  -1  -1  -1
