-1  -1  -1  -1  -1  -1  -1  -1
42  42  -1  -1  -1  -1  42  42
42  42  -1  -1  -1  -1  42  42
-1  -1  -1  -1  -1  -1  -1  -1
-1  -1  -1  -1  -1  -1  -1  -1
-1  -1  41  41  -1  -1  -1  -1
-1  -1  41  41  -1  -1  -1  -1
-1  -1  -1  -1  -1  -1  -1  -1
-1  -1  -1  -1  -1  -1  41  41
-1  -1  -1  -1  -1  -1  41  41
-1  -1  -1  -1  -1  -1  -1  -1
-1  -1  -1  -1  -1  -1  -1  -1
42  -1  -1  42  42  -1  -1  42
42  -1  -1  42  42  -1  -1  42
-1  -1  -1  -1  -1  -1  -1  -1
